atemlos	ADV
außer	ADJA
außerordentlichen	ADJA
außerordentlicher	ADJA
außerordentliches	ADJA
bewusstlos	ADV
dies	PDS
es	PPER
fruchtlosen	ADJA
gefahrlos	ADJD
hilflos	ADJD
kein	PIAT
keine	PIAT
keinen	PIAT
keiner	PIAT
keiner	PIS
keinerlei	PIAT
keines	ADJA
keinesfalls	ADV
lautlos	ADJD
nein	ADV
nein	NN
nein	PTKANT
nicht	PTKNEG
nichts	NN
nichts	PIAT
nichts	PIS
nichts	PTKANT
nie	ADV
niemals	ADV
niemand	PIS
niemandem	PIS
niemanden	PIS
nirgends	ADJA
nirgends	NN
nirgendwo	ADV
noch	ADV
noch	KON
nutzlos	ADV
nutzloser	ADJA
ohne	APPR
ohne	KOUI
ratlos	ADJD
reglos	ADJD
reglosigkeit	NN
schamlosen	ADJA
sinnlos	ADJD
unachtsam	ADJD
unachtsamkeit	NN
unangenehme	ADJA
unangenehmen	ADJA
unausgesprochenen	ADJA
unauslöschlich	ADJD
unbarmherzigen	ADJA
unbefestigten	ADJA
unbefriedigendem	ADJA
unbeholfener	ADJA
unbekannte	NN
unbekannter	ADJA
unbekannter	NN
unbeschriebener	ADJA
unbesetzte	NN
unbewegten	ADJA
unendlicher	ADJA
unerbittlich	ADJD
unerforscht	VVFIN
unerklärt	ADJD
unerschütterlichen	ADJA
unerwarteter	ADJA
unfair	ADJD
unfair	VVPP
ungastlichen	ADJA
ungebildet	VVINF
ungeduldig	ADJD
ungeduldig	ADV
ungeheuren	ADJA
ungeschickt	ADJD
ungeschützt	VVPP
ungetragener	ADJA
ungewohnt	ADJA
ungewöhnlich	ADJD
ungewöhnlichen	ADJA
ungewöhnlicher	ADJD
unglaublich	ADJD
unglaubliche	ADJA
unglückliche	ADJA
unglücklichen	ADJA
unheimliches	ADJA
unmittelbar	ADJD
unmittelbar	NN
unmittelbaren	ADJA
unmöglich	ADJD
unmöglich	VVPP
unnatürlichen	ADJA
unnötiges	ADJA
unregelmäßiges	NN
unruhige	ADJA
unschuldig	ADJD
unschätzbarem	ADJA
unsicheren	ADJA
unsichtbare	ADJA
unsichtbaren	ADJA
unstetes	ADJA
untaten	NN
untier	NN
untiers	NN
untröstlichen	ADJA
unumstößlich	ADJD
unvereinbare	ADJA
unverheiratet	ADJD
unverheiratet	VVPP
unverheiratete	ADJA
unverwechselbares	NN
unvorsichtig	ADJD
unwahrscheinlich	ADJD
unwiderruflichen	ADJA
unüberwindlichen	ADJA
vorbehaltlos	ADJD
vorbehaltlos	ADV
vorhanglose	ADJA
weder	KON
zweifellos	ADJD
zweifellos	ADV
zweifelsfrei	ADJD
